21 31
   ############################
      #        #     #        #
#  ####  ####  #  ####  #  #  #
#  #        #  #     #  #  #  #
#  #  ####  ####  #######  #  #
#        #  #           #  #  #
#######  ##########  #######  #
#        #     #     #        #
####  ####  ####  #######  #  #
#     #  #        #  #     #  #
#  ####  ####  ####  #  #######
#           #           #     #
#  ################  ####  ####
#        #           #  #  #  #
####  #  #  #  #  #  #  #  #  #
#     #  #  #  #  #           #
#  #  #  ####  #  #######  ####
#  #  #  #     #     #  #  #  #
#  #######  #  #######  #  #  #
#           #        #        
############################  